111111111
10P000C01
111111101
100C11001
10C0000E1
100000001
111111111
