111111111111
1P0C11111111
1000E1111111
1111111111111
