11111111111111
1P000C00100001
1C000C0010C001
10C00C00110111
1C000C0000C0E1
11111111111111