11111
10P01
11011
100C1
1E001
11111