11111
10P01
11011
11C11
10E01
11111
