11111111111111
10000000PE0C11
10000000000111
10000000000C11
11111111111111
