11111
10P01
11C11
11111
1E001
11111