11111111111
1P0C1111111
1000E111111
11111111111
