111111111111111111111
100000000000000000001
101111011111011110101
101000000000000000101
101011111011111110101
101000001000000010101
1011111E1111110111101
100000000P00000000001
101111101111110111101
101000001000000010101
101011101011111110101
101000000000000000101
101111011111011110101
1C0000000000000000011
111111111111111111111