111111111111111111111
1P0000000000000000001
101111011111011110101
101000000000000000101
1E1011111011111110101
101000101000000010101
101111101111110111101
1000010C1000000000001
101111101111110111101
101000001000000010101
101011101011111110101
101000000000000000101
101111011111011110101
100000000000000000011
111111111111111111111