11111111111111111111111111111111
10000000000000C0000000000C0011E1
1000000000000100000C00000C0011C1
11111111111100111111111111111101
1000C000000000C000000000000000C1
11111111001111111111111111111111
1000C000000000C0000000000000C001
11111111111111111111111001111111
1000C000000000C000000000000000C1
10111111111111111111111111111111
1000C000000000C000000000000000P1
11111111111111111111111111111111