111111111111111111111111
100000000000000000001111
101111011111011110101111
101000000000000000101111
101011111011111110101111
101000101000000010101111
1011111E1111110111101111
1000000C0000000000001111
101111101111110111101111
101000001000000010101111
101011101011111110101111
101000000000000000101111
101111011111011110101111
100000000P00000000011111
111111111111111111111111
