1111111111111111111111111
100000000000E0000000000P1
1011110111110111111101101
10100000C00000000000C0101
1010111110111111101111101
10100C0010000000100000101
1011111011111101111011101
1000000000000000000000001
1011111011111101111011101
101000C01000000001000C101
1010111110111111101111101
10100C00000000000000C0101
1011110111110111111101101
100C000C00C000C000C000001
1111111111111111111111111
