1111111111111111111111111
1ECCCCCCCCCCCCCCCCCCCCCC1
1C11CC111CCCCCC111CC110C1
1CC0CCCC0CC0CCC0CCCC0C011
1CC0CC0CC0C0C0CCCC0C01111
1CC0CCCC0CC0C0CCC0CCCC0C1
1C0C0CCCCCC0CCCC0C0111111
1CCCCCCCCCCCPCCCCCCCCCCC1
1CCCCCCCCCCCCCCCCCCCCCCC1
1C0C0CC0CCC0CCCC011111111
1CCC0C0C0CCCC0CCCCC0CCCC1
1C01CCCCCC111CCC111CCCC11
1C1CCC1C1CC1CCCCC1CCCCCC1
1C111C111CC111CCC111CCCC1
1CCCCCCCCCCCCCCCCCCCCCCC1
1111111111111111111111111
